WWWWWWWWWWWWWWWWWWWWWWWWW
W.S....W....E..W.WWW....W
W..W.W.W.W.WWWWW...W.WW.W
W..WWW.W.W.....W.W.W..W.W
WW..W....WWWWW.W.W.W..W.W
W...W...WW.W.W.W.W.WW.W.W
W.WWWWW.W..W.....W....W.W
W.W.......WWW..WWWWW.WW.W
W.W.WWW..WW.WWWW....W...W
W.....W.....W..W.WW.W.WWW
W.WWWWW.W.WWW..W..W.....W
W.......W..W...WW.W.....W
WWWWW.WWWW.WWWW...W.....W
W.......W....W.W........W
WWWWWWWWWWWWWWWWWWWWWWWWW
